ARE	AA R
ARE(2)	ER
AROUND	ER AW N D
AROUND(2)	ER AW N
BEGIN	B IH G IH N
CAN	K AE N
CAN(2)	K AH N
EXPERIMENT	IH K S P EH R AH M AH N T
EXPLORE!	IH K S P L OW R
FORWARD	F AO R W ER D
HEAR	HH IY R
HELLO!	HH AH L OW
HOW	HH AW
LEFT	L EH F T
LET'S	L EH T S
ME?	M IY
MOVE	M UW V
RIGHT	R AY T
THE	DH AH
THE(2)	DH IY
TODAY?	T AH D EY
TURN	T ER N
YOU	Y UW
